1,1,1,1,1,1,1,4,1,1
1,1,1,1,1,1,1,1,1,1
0,0,0,0,0,0,0,0,0,13
0,0,0,0,0,0,0,0,0,0
0,0,0,0,0,0,0,0,0,0
12,0,0,0,0,0,0,0,0,0
1,1,1,1,1,1,1,1,1,1
1,1,4,1,1,1,1,1,1,1
