1,1,1,1,0,0,0,0,1,1
1,1,1,11,0,0,0,0,0,1
1,1,11,0,0,0,0,0,0,1
0,0,0,0,0,0,0,6,13,1
0,0,0,0,0,0,0,0,13,1
1,1,11,0,0,0,0,0,0,1
1,1,1,11,0,0,0,0,0,1
1,1,1,1,0,0,0,0,1,1
