1,1,1,1,1,1,1,1,1,1
1,1,1,1,1,1,1,1,1,1
8,8,8,8,8,8,8,8,8,8
0,0,0,0,0,0,0,0,0,0
0,0,0,0,0,0,0,0,0,0
9,9,9,9,9,9,9,9,9,9
1,1,1,1,1,1,1,1,1,1
1,1,1,1,1,1,1,1,1,1
