1,1,0,0,0,0,1,1,1,1
1,4,11,0,0,0,11,1,1,1
1,11,0,0,0,0,0,11,1,1
1,5,0,0,0,0,0,0,0,0
1,5,0,0,0,0,0,0,0,0
1,11,0,0,0,0,0,11,1,1
1,4,11,0,0,0,11,1,1,1
1,1,0,0,0,0,1,1,1,1
