1,1,1,1,1,1,1,1,1,1
1,1,1,1,1,1,1,1,1,1
9,9,9,9,11,11,8,8,8,8
0,0,0,0,0,0,0,0,0,0
0,0,0,0,0,0,0,0,0,0
9,9,9,9,11,11,8,8,8,8
1,1,1,1,1,1,1,1,1,1
1,1,1,1,1,1,1,1,1,1
