5,5,5,5,5,5,5,5,5,5
5,8,0,0,0,0,0,0,8,5
5,0,0,0,0,0,0,0,0,5
5,0,0,0,4,0,6,0,0,5
5,0,0,0,0,0,0,0,0,5
5,0,0,0,0,0,7,0,0,5
5,8,0,0,0,0,0,0,8,5
5,5,5,5,5,5,5,5,5,5
